ребята: лагер, соревнование, скакалка, рыбка, скворечник
участник: дорожка, соревнование, длина, бассейн, часть
животное: берег, лодка, планета, земля, место
кит: тигр, планета, длина, млекопитающее, животное
жираф: земля, рост, кит
медсестра: рост
настя: катя
маша: катя, лисичка, подосиновик, варение, шишка
девочка: сантиметр, день, книга, страница, встреча
кошка: хвост, зуб, длина, гепард, мурка
грач: птенец, червь, раз
наташа: страница, день, каникулы, книга, класс
петя: раз, урок, физкультура, класс
максим: раз, урок, физкультура, алеш, партия
утка: год, хозяйка, курица, добавка, день
гусь: год, килограмм, зерно, двор, курица
муравей: соломинка, дом, муравейник
третьеклассник: книга, акция, жизнь, библиотека
ученик: класс, книга, раз, библиотека, соревнование
баскетболист: раз, мяч, корзина, время, матч
белка: заяц, зима, семя, шишка, лес
библиотекарь: ребёнок, книга
денис: фигура, часть, книжка, страница, денис
мама: загадка, раз, книга, молоко, гвоздика
папа: раз, загадка, эрдем, камера, сайгак
ребёнок: загадка, школа, клён, липа, штука
велогонщик: день, соревнование, километр, расстояние
полозов: гадюка, штука
уж: гадюка, штука
художник: рисунок, зверь
катя: кисть, рябина, раз, девочка, волейбол
орёл: птенец, раз, год, хищник, мир
орлица: орлёнок, год
пчела: цвет, мёд, путь, длина, экватор
кот: матроскин, день, сказка, пескарь, раз
леопольд: матроскин, пескарь, раз, пакость, неделя
собака: зуб, берег, год, раз, щенок
кролик: грядка, банка, варение, год, морковь
легкоатлет: соревнование, круг, стадион
мальчик: девочка, страница, раз, паук, волейбол
взрослый: время, кампания, постриг, овца, раз
бегемот: 
птица: хвост, длина, австралия, форма, инструмент
лирохвост: австралия, хвост, форма, инструмент, страна
лир: австралия, хвост, форма, инструмент
пиявка: обед, вес, кровь, раз
орнитолог: воробей, зяблик
вертишейка: потомство, гусеница
жуков: стрекоза, бабочка, паук, поляна, вид
попугай: год, кеш, история, пеликан, популярность
ворон: дерево, берёза, год, раз, ворона
курица: яйцо, год, раз, добавка, день
корова: молоко, сутки, раз, литр, день
корова-рекордсменка: раз, молоко
саша: раз, урок, физкультура
митя: раз, стихотворение, четверг, урок, физкультура
белка-летяга: белок, прыжок, длина, метр
кенгуру: прыжок, длина, высота, вид, нога
ара: длина, попугайчик, америка, сантиметр, попугай
попугайчик: длина, попугайчик, америка, сантиметр, попугай
баран: длина, хвост, сантиметр, базар, баранка
муфлон: длина, хвост
альбатрос: год, раз, птица
ястреб: год, раз, альбатрос, лошадь
воробей: день, корм, километр
виктор: галина, день, борис, елена, андрей
ныряльщик: дно, море, устрица
обезьяна: клетка, год
верблюд: год, день, пустыня, километр, путь
двух-трёх: медвежонок, медведица, январь-февраль
скворец: саранча, день, грамм
птичка: масса, мир, трясогузка, день, корм
колибри: мир
синица: день, гнездо, раз, птенец, паук
личинка: день, гнездо, раз, птенец, паук
заяц: шаг, заяц, раз, лес, след
коля: пример, спорт, мина, столбик, волейбол
кондор: величина, птица, долгожитель, год
пеликан: год, пеликан
садовник: хризантема, клумба
нина: флажок, песня, кисть, рябина, раз
миша: спорт, вид, шишка, варение, задача
школьник: слово, дерево, класс, участок, свёкла
хозяйка: бидон, молоко, нож, литр
лимонов: банан, лимон, масса
велосипедист: 
итальянец: жест, разговор, час
француз: жест, разговор, час
мексиканец: жест, разговор, час
учёный: сказка, день, шахматы, год
белые: половина
конь: фигура, поле, ход
организатор: игра, соревнование, память, положение, фигура
шахматист: игра, соревнование, память, положение, фигура
франсуа: год, доска, игрок, филидора, мигель
найдорф: год, доска, игрок, филидора, мигель
угорь: река, эльба, германия, вид, рыба
камбала: река, эльба, германия, вид, рыба
корюшка: река, эльба, германия, вид, рыба
краб: пара, челюсть, мусор, рыбёшка
индюк: двор, козочка, нога, гол
сестра: слив, деньга, половина
болельщик: начало, соревнование
гном: страница, книга, белоснежок, цвет, килограмм
брат: слив, уха, штука, количество, рыба
волк: заяц, шаг, раз, мясо, берег
друг: друг, длина, расстояние, сторона, колышек
юра: день, высота, канат, потолок, страница
барби: домик
врач: лекарство, таблетка, мина
турист: вода, родник, количество, банк
старший: окунь, улов
малыш: карлсон, плюшка, кусочек, торт, крыша
кикиморк: дочь
внучек: кикиморок, дочь, кикимора
хоббит: шишка, раз
добывайк: шишка, раз
грязнуля: пачка, мыло, шампунь
волков: килограмм, мясо, заповедник
людоед: пончик, толстяк, раз
муха-цокотуха: гость, чашка, базар, тарелка, денежка
тотоша: кокош, галоша, пара
хулиган: задание
дедушка: мина, раз, телефон, дедушка, окно
бабушка: мина, раз, пара, носка, иджилин
внучка: телефон, мина, дедушка, раз, минута
начальник: мойдодыра, умывальник, мочалка
командир: мойдодыра, умывальник, мочалка
мадина: страница, день
пчёлка: лапка, рак
артём: сыроежка
боровиков: сыроежка
юля: загадка, страница
алёна: страница
марина: егор, год
гость: мина, тарелка, стол, оладушка, кощей
человек: класс, кружка, салон, лодка, хор
оля: лист, загадка, страница, открытка, зазевалкина
надя: письмо, подруга, день, рождение, бабушка
вова: бабочка, дорога, щенок
столяр: стул, вещь, стол, полка
шаров: праздник, новоселье, теремок, украшение, сцена
мингиян: джангар, песня, эпос, раз, ангир
лиджи: карась, раз, санал
эрдниевич: карась, раз, санал
сын: раз, карась, санал, время, кампания
ногала: пара, носка, иджилин, раз
швея: платье, жилет, орнамент, раз
внук: благопожелание, окно, раз
дочь: неделя, шапка, раз
энкира: шапка, неделя, раз
лука: соревнование, стрельба, очко, дунгар, раз
мерген: очко, раз, эрдем, соревнование, стрельба
жеребец: аранзал, скачка, раз
арслан: раз, эрдень
альмина: книга, библиотека
отец: овца, сын
муниева: 
сладкоежкин: обед, пирог, ужин, повидло, капуста
спортсмен: медаль, соревнование, атлетика
учитель: класс, слово, школа, мяч, физкультура
приседайкин: физкультура, школа, мяч
музыкант: оркестр, гитара, балалайка, баян
житель: новоселье, теремок
сороконожка: яблоко, груша
линдгрен: год, герой, повесть, астрид, малыш
юли: орех, арахис
младенец: сутки
кузя: картинка, лунтик, сутки, час, домовёнок
стас: страница, день
слон: сутки, час, еда, килограмм, картофель
серёжа: страница, обед, волейбол, теннис, день
полянин: гриб, лисичка, сыроежка, ушастик, цветок
коза: берег, капуста, верёвка, наволочка, лодка
люська: верёвка, наволочка
джема: баночка, руб
фрекен: бок, плюшка
портной: рубашка
нюша: тарелка
знайк: библиотека, полка, книга
ариэль: библиотека, принцесса, книга, полка
громозек: шуруп, тарелка, банан
старуха: уха, рыба, шапокляк, шарик
барсук: килограмм, пища, сутки
медведь: обед, килограмм, пища, сутки
второклассник: зуб, ученик, класс
почтальон: газета, журнал, подписчик, штука
витя: страница, дорога, дом, школа, мина
щенок: длина
ежонок: груздь, зима, рыжик, килограмм, гриб
бельчонок: груздь, зима, рыжик, килограмм, гриб
ветеринар: прививка, куропатка, лебедь
копатыч: куст, огород, картофель, малина, килограмм
толя: страх, спин, мурашки
динозавр: животное, история, земля
суперзавр: динозавр
мальвина: тетрадь, печка, карабас-барабас, дом, папа
ёжик: гриб
крокодил: друг, отделка, дом, чебурашка, ген
эльф: дюймовочка, букет, цвет, роза
астр: букет, дюймовочка, цвет, роза
марья-искусница: рубашка, батюшка
мышонок: кот, леопольд, пирожок
студент: экзамен
старик: порция, мороженое, хоттабыча, невод, окунь
майя: цвет, нектар, утро, обед
хомяк: орех
тролль: сокровище, сундук
машенька: медведь, мясо, малина, дом, мина
мачеха: мука, работа, золушка, смесь
мила: картинка, лунтик
михаил: улей, пасека, дом, мина, пирожок
потапович: улей, пасека, дом, мина, пирожок
топтыгин: улей, пасека, дом, мина, пирожок
баба-яга: мина, кощей, ступа, метла, кочка
илья: кружка, вода, квас, бочонок, ведро
муромец: кружка, вода, квас, бочонок, ведро
разбойница: попугай, клетка
звездочёт: звезда, небо
золушка: тарелка, чашка, ложка, платье, кружево
женщина: мужчина, театр, премьера, спектакль, ребёнок
дачник: лето, малина, смородина, килограмм, ягода
гусеница: яблоко, груша, апельсин
художник-мультипликатор: стол, шкаф, стул, создание, мультфильм
боцман: яхта, катер, лодка, время, путешествие
рома: яхта, катер, лодка, время, путешествие
карпов: пруд, ёрш, сеть, рыбак, карась
жилец: матч, команда, дом, стекло, окно
рыболов: 
медвежонок: рыбёшка, ромашка, медведица, мама, тилимилитрямдия
киви: тарелка, банан
ксюша: сантиметр, илюша
илюша: сантиметр, ксюша
гали: год, шарик, дружка
дружка: год, шарик
балаболкин: 
вася: класс
тараторкин: килограмм, балаболкин
щука: год, форель
лев: герб, страна
тигр: герб, страна
хищник: длина, тело
ласка: длина, тело, сантиметр
горностай: длина, тело, сантиметр
бобёр: грызун
ондатра: длина, хвост
налим: длина
лещ: длина, налим
люся: день, страница, прилежайкин, энциклопедия
алладин: сокровище, разбойник, цепочка, сундук, мешок
малышок: город, коротышка, малыш
пантера: добыча, трава, песок
рыбак: окунь, пескарь, рыба, щука, карась
бычков: рыба, щука, окунь
джузеппе: вещь, стол, стул, полка
дрессировщик: выступление, хищник, тигр, пантера, лев
мишка: мешок, дед, мороз, ребята, игрушка
зайчонок: ромашка, мешок, дед, мороз, ребята
вадим: кролик, лето, петя
дед: подарок, праздник, яйцо, яичница, хулиганство
мороз: подарок, праздник
снегурочка: подарок, праздник
призёр: балл, место, второе, олимпиада, сумма
стёпа: отметка, оценка
незнайка: друг, аллея, знайк, встреча, кусок
котёнок: длина, килограмм, вес
изобретатель: шар, модель, день, раз, ветер
пума: добыча, трава, метр
орангутанг: сутки, среднее, время, течение
винни-пух: мёд, зима, горшочек, килограмм
буратино: монета, копилка, урожай, печка, руб
учительница: ученик, тетрадь
хорёк: мышка, малыш, ребёночек
принц: букет, золушка, роза, цветок
всезнайкин: пример, столбик
слуга: тумак
путник: день, кувшин, кисель
птенец: завтрак, орёл, мышь
член: охота, добыча, племя, носилки, жердь
раб: течение, месяц
ваня: ручка, руб, рубль
акула: рыбина, пища, килограмм, запас, отдел
алиса: альбом, руб, урожай, дерево
водяной: заклинание
русалка: заклинание
доктор: крокодил, зайчонок
айболит: крокодил, зайчонок
гарри: страница, длина, палочка, неделя, книга
поттер: страница, неделя
оленёнок: заповедник, олень
валя: денис, фигура
солдатик: слава
лиса: урожай, дерево
базилио: урожай, монета, дерево, половина, лиса
галя: волейбол, теннис, спорт
галей: вид, спорт, катя, серёжа
улитка: столб, высота
кай: герд, салфетка, снежинка, год, крепость
нуф-нуф: наф-наф
ниф-ниф: наф-наф
курочка: яйцо
ряба: яйцо
мышка: яйцо, яичница, хулиганство
баба: яйцо, яичница, хулиганство
усов: школа, портрет, писатель, ус
дядя: форточка, полотенце, комната, муха
гоша: форточка, полотенце, комната, муха
пьеро: карабас-барабас, дом, папа, карло
зайчик-побегайчик: место, строительство, теремок, бревно, колесо
лягушка-квакушка: место, строительство, теремок, бревно, колесо
элли: друг, тигр
женя: алеш, партия, шахматы, лида, инструмент
дима: алеш, партия, шахматы
аня: класс
лыжник: класс
андрей: галина, борис, елена, андрей, первенство
борис: галина, борис, елена, андрей, первенство
галина: галина, борис, елена, андрей, первенство
дмитрий: первенство, класс, теннис, участник
елена: первенство, класс, теннис, участник
николай: сын, рыбалка, рыба
пётр: берег, лев, сын, остров, рыбалка
король: поле, доска
игрок: король, место, время, матч, травма
лена: концерт
крестьянин: волк, коза, мешок, капуста, река
фермер: выводок, звёздочка, гусеница, четырёхглаз, питомец
пёс: гусь, зерно, берег, корзина, присмотр
укротитель: берег, остров, река, лев, право
леонид: берег, пума, остров, река, лев
